{
  "moves": 20,
  "grid": [
    ["🧱", "🧱", "🧱", "🧱", "🧱", "🧱", "🧱", "🧱", "🧱", "🧱", "🧱", "🧱", "🧱"],
    ["🧱", "🥚", "🟩", "🟩", "🟩", "🧱", "🟩", "🟩", "🟩", "🟩", "🟩", "🟩", "🧱"],
    ["🧱", "🟩", "🧱", "🧱", "🟩", "🧱", "🟩", "🧱", "🧱", "🧱", "🟩", "🟩", "🧱"],
    ["🧱", "🟩", "🧱", "🧱", "🟩", "🟩", "🟩", "🧱", "🟩", "🟩", "🧱", "🟩", "🧱"],
    ["🧱", "🧱", "🧱", "🧱", "🧱", "🧱", "🟩", "🧱", "🧱", "🟩", "🧱", "🟩", "🧱"],
    ["🧱", "🧱", "🟩", "🟩", "🟩", "🧱", "🟩", "🟩", "🟩", "🟩", "🧱", "🟩", "🧱"],
    ["🧱", "🟩", "🟩", "🧱", "🟩", "🧱", "🧱", "🧱", "🧱", "🧱", "🧱", "🟩", "🧱"],
    ["🧱", "🟩", "🍳", "🟩", "🟩", "🟩", "🧱", "🧱", "🟩", "🟩", "🟩", "🟩", "🧱"],
    ["🧱", "🟩", "🧱", "🟩", "🧱", "🧱", "🧱", "🧱", "🟩", "🧱", "🟩", "🟩", "🧱"],
    ["🧱", "🟩", "🧱", "🟩", "🟩", "🟩", "🟩", "🧱", "🟩", "🧱", "🧱", "🧱", "🧱"],
    ["🧱", "🟩", "🧱", "🧱", "🧱", "🧱", "🟩", "🧱", "🟩", "🟩", "🟩", "🧱", "🧱"],
    ["🧱", "🟩", "🧱", "🧱", "🧱", "🧱", "🟩", "🧱", "🧱", "🧱", "🟩", "🧱", "🧱"],
    ["🧱", "🟩", "🟩", "🟩", "🟩", "🧱", "🟩", "🟩", "🟩", "🟩", "🟩", "🧱", "🧱"],
    ["🧱", "🧱", "🧱", "🟩", "🧱", "🧱", "🟩", "🟩", "🧱", "🟩", "🟩", "🟩", "🧱"],
    ["🧱", "🧱", "🟩", "🟩", "🟩", "🧱", "🧱", "🧱", "🧱", "🧱", "🧱", "🧱", "🧱"],
    ["🧱", "🧱", "🧱", "🧱", "🟩", "🟩", "🟩", "🟩", "🟩", "🟩", "🟩", "🪹", "🧱"],
    ["🧱", "🧱", "🧱", "🧱", "🧱", "🧱", "🧱", "🧱", "🧱", "🧱", "🧱", "🧱", "🧱"]
  ]
}



  