{
    "grid": [
    ["🧱", "🧱", "🧱", "🧱", "🧱", "🧱", "🧱", "🧱", "🧱", "🧱", "🧱", "🧱", "🧱", "🧱", "🧱"],
    ["🧱", "🧱", "🧱", "🧱", "🟩", "🟩", "🧱", "🧱", "🧱", "🟩", "🟩", "🧱", "🧱", "🧱", "🧱"],
    ["🧱", "🧱", "🧱", "🟩", "🟩", "🟩", "🟩", "🧱", "🧱", "🟩", "🟩", "🟩", "🧱", "🧱", "🧱"],
    ["🧱", "🧱", "🟩", "🟩", "🧱", "🧱", "🟩", "🥚", "🥚", "🟩", "🧱", "🟩", "🟩", "🧱", "🧱"],
    ["🧱", "🍳", "🟩", "🧱", "🧱", "🧱", "🧱", "🟩", "🟩", "🧱", "🧱", "🧱", "🟩", "🍳", "🧱"],
    ["🧱", "🍳", "🟩", "🧱", "🧱", "🧱", "🧱", "🍳", "🧱", "🧱", "🧱", "🧱", "🟩", "🍳", "🧱"],
    ["🧱", "🧱", "🟩", "🟩", "🧱", "🧱", "🧱", "🧱", "🍳", "🧱", "🧱", "🟩", "🟩", "🧱", "🧱"],
    ["🧱", "🧱", "🧱", "🟩", "🟩", "🧱", "🧱", "🍳", "🧱", "🧱", "🟩", "🟩", "🧱", "🧱", "🧱"],
    ["🧱", "🧱", "🧱", "🧱", "🟩", "🟩", "🧱", "🧱", "🧱", "🟩", "🟩", "🧱", "🧱", "🧱", "🧱"],
    ["🧱", "🧱", "🧱", "🧱", "🧱", "🟩", "🪹", "🍳", "🪹", "🟩", "🧱", "🧱", "🧱", "🧱", "🧱"],
    ["🧱", "🧱", "🧱", "🧱", "🧱", "🧱", "🟩", "🟩", "🟩", "🧱", "🧱", "🧱", "🧱", "🧱", "🧱"],
    ["🧱", "🧱", "🧱", "🧱", "🧱", "🧱", "🧱", "🧱", "🧱", "🧱", "🧱", "🧱", "🧱", "🧱", "🧱"]
    ],
    "max_moves": 30
  }