{
    "grid": [
        ["🧱", "🧱", "🧱", "🧱", "🧱", "🧱", "🧱", "🧱", "🧱", "🧱", "🧱", "🧱", "🧱", "🧱", "🧱", "🧱", "🧱", "🧱", "🧱"],
        ["🧱", "🍳", "🟩", "🟩", "🟩", "🟩", "🟩", "🟩", "🧱", "🧱", "🧱", "🟩", "🟩", "🟩", "🟩", "🍳", "🧱", "🪹", "🧱"],
        ["🧱", "🟩", "🟩", "🟩", "🟩", "🟩", "🟩", "🟩", "🟩", "🧱", "🟩", "🟩", "🟩", "🧱", "🍳", "🟩", "🟩", "🟩", "🧱"],
        ["🧱", "🟩", "🧱", "🧱", "🟩", "🧱", "🟩", "🟩", "🧱", "🧱", "🟩", "🟩", "🟩", "🟩", "🟩", "🟩", "🟩", "🧱", "🧱"],
        ["🧱", "🟩", "🧱", "🧱", "🥚", "🧱", "🟩", "🟩", "🟩", "🟩", "🟩", "🧱", "🟩", "🧱", "🧱", "🧱", "🧱", "🧱", "🧱"],
        ["🧱", "🟩", "🟩", "🟩", "🟩", "🧱", "🟩", "🧱", "🧱", "🧱", "🟩", "🟩", "🟩", "🟩", "🧱", "🧱", "🍳", "🟩", "🧱"],
        ["🧱", "🟩", "🟩", "🟩", "🟩", "🧱", "🟩", "🟩", "🟩", "🟩", "🟩", "🧱", "🟩", "🟩", "🟩", "🟩", "🧱", "🥚", "🧱"],
        ["🧱", "🟩", "🧱", "🟩", "🟩", "🧱", "🧱", "🟩", "🟩", "🟩", "🟩", "🧱", "🟩", "🟩", "🟩", "🟩", "🟩", "🟩", "🧱"],
        ["🧱", "🧱", "🟩", "🟩", "🟩", "🟩", "🟩", "🧱", "🟩", "🟩", "🟩", "🧱", "🟩", "🧱", "🟩", "🧱", "🧱", "🧱", "🧱"],
        ["🧱", "🍳", "🟩", "🟩", "🧱", "🟩", "🧱", "🧱", "🟩", "🧱", "🟩", "🧱", "🟩", "🟩", "🟩", "🧱", "🍳", "🧱", "🧱"],
        ["🧱", "🧱", "🟩", "🟩", "🟩", "🟩", "🟩", "🟩", "🟩", "🧱", "🟩", "🟩", "🟩", "🟩", "🟩", "🧱", "🟩", "🧱", "🧱"],
        ["🧱", "🟩", "🟩", "🟩", "🟩", "🧱", "🟩", "🟩", "🟩", "🧱", "🟩", "🟩", "🟩", "🟩", "🟩", "🧱", "🟩", "🧱", "🧱"],
        ["🧱", "🟩", "🟩", "🧱", "🟩", "🟩", "🟩", "🟩", "🟩", "🧱", "🟩", "🧱", "🟩", "🟩", "🟩", "🟩", "🟩", "🧱", "🧱"],
        ["🧱", "🧱", "🟩", "🟩", "🟩", "🟩", "🟩", "🧱", "🟩", "🧱", "🟩", "🟩", "🟩", "🟩", "🧱", "🧱", "🟩", "🧱", "🧱"],
        ["🧱", "🧱", "🧱", "🧱", "🟩", "🧱", "🟩", "🟩", "🟩", "🧱", "🟩", "🟩", "🟩", "🟩", "🧱", "🧱", "🟩", "🧱", "🧱"],
        ["🧱", "🧱", "🟩", "🟩", "🟩", "🧱", "🟩", "🟩", "🪹", "🧱", "🟩", "🟩", "🟩", "🟩", "🟩", "🧱", "🟩", "🧱", "🧱"],
        ["🧱", "🟩", "🟩", "🟩", "🧱", "🟩", "🟩", "🟩", "🧱", "🧱", "🟩", "🟩", "🟩", "🟩", "🧱", "🧱", "🟩", "🧱", "🧱"],
        ["🧱", "🟩", "🟩", "🟩", "🟩", "🟩", "🟩", "🟩", "🧱", "🧱", "🟩", "🟩", "🧱", "🟩", "🟩", "🧱", "🟩", "🧱", "🧱"],
        ["🧱", "🟩", "🟩", "🧱", "🟩", "🟩", "🟩", "🟩", "🟩", "🧱", "🟩", "🟩", "🟩", "🟩", "🟩", "🧱", "🟩", "🧱", "🧱"],
        ["🧱", "🟩", "🟩", "🟩", "🟩", "🟩", "🟩", "🟩", "🟩", "🧱", "🟩", "🟩", "🟩", "🧱", "🟩", "🧱", "🟩", "🧱", "🧱"],
        ["🧱", "🟩", "🟩", "🟩", "🟩", "🟩", "🧱", "🟩", "🟩", "🧱", "🥚", "🟩", "🟩", "🟩", "🧱", "🧱", "🟩", "🪹", "🧱"],
        ["🧱", "🧱", "🧱", "🧱", "🧱", "🧱", "🧱", "🧱", "🧱", "🧱", "🧱", "🧱", "🧱", "🧱", "🧱", "🧱", "🧱", "🧱", "🧱"]
    ],
    "max_moves": 21
  }